ID,NAME,PARENT,YEAR,TOTAL,INCREASE,MIGRATION,CHANGE
1,LATVIJA,,1990,2668140,3106,-13085,-9979
2,LATVIJA,,1991,2658161,-116,-15045,-15161
3,LATVIJA,,1992,2643000,-3851,-53474,-57325
4,LATVIJA,,1993,2585675,-12438,-32333,-44771
5,LATVIJA,,1994,2540904,-17501,-22823,-40324
6,LATVIJA,,1995,2500580,-17336,-13713,-31049
7,LATVIJA,,1996,2469531,-14538,-10081,-24619
8,LATVIJA,,1997,2444912,-14703,-9420,-24123
9,LATVIJA,,1998,2420789,-15790,-5751,-21541
10,LATVIJA,,1999,2399248,-13448,-4085,-17533
11,LATVIJA,,2000,2381715,-11903,-16428,-28331
12,LATVIJA,,2001,2353384,-13265,-19163,-32428
13,LATVIJA,,2002,2320956,-12371,-9195,-21566
14,LATVIJA,,2003,2299390,-11286,-11584,-22870
15,LATVIJA,,2004,2276520,-11473,-15323,-26796
16,LATVIJA,,2005,2249724,-10898,-10952,-21850
17,LATVIJA,,2006,2227874,-10227,-8807,-19034
18,LATVIJA,,2007,2208840,-9084,-7946,-17030
19,LATVIJA,,2008,2191810,-6609,-22367,-28976
20,LATVIJA,,2009,2162834,-7853,-34477,-42330
21,LATVIJA,,2010,2120504,-10259,-35640,-45899
22,LATVIJA,,2011,2074605,-9715,-20077,-29792
23,LATVIJA,,2012,2044813,-9128,-11860,-20988
24,LATVIJA,,2013,2023825,-8095,-14262,-22357
25,LATVIJA,,2014,2001468,-6720,-8652,-15372
26,LATVIJA,,2015,1986096,-6499,-10640,-17139
27,LATVIJA,,2016,1968957,-6612,-12229,-18841
28,LATVIJA,,2017,1950116,-7929,-7808,-15737
29,LATVIJA,,2018,1934379,-9506,-4905,-14411
30,LATVIJA,,2019,1919968,-7929,-7808,-15737
31,RIGA,LATVIJA,1990,909135,-273,-8407,-8680
32,RIGA,LATVIJA,1991,900455,-1481,-9233,-10714
33,RIGA,LATVIJA,1992,889741,-3101,-22983,-26084
34,RIGA,LATVIJA,1993,863657,-6074,-14031,-20105
35,RIGA,LATVIJA,1994,843552,-7326,-11238,-18564
36,RIGA,LATVIJA,1995,824988,-6908,-7908,-14816
37,RIGA,LATVIJA,1996,810172,-5361,-6864,-12225
38,RIGA,LATVIJA,1997,797947,-5453,-5882,-11335
39,RIGA,LATVIJA,1998,786612,-5511,-5093,-10604
40,RIGA,LATVIJA,1999,776008,-5067,-4560,-9627
41,RIGA,LATVIJA,2000,766381,-4627,-8748,-13375
42,RIGA,LATVIJA,2001,753006,-4713,-9697,-14410
43,RIGA,LATVIJA,2002,738596,-3821,-5557,-9378
44,RIGA,LATVIJA,2003,729218,-3159,-4419,-7578
45,RIGA,LATVIJA,2004,721640,-2982,-6396,-9378
46,RIGA,LATVIJA,2005,712262,-2672,-2973,-5645
47,RIGA,LATVIJA,2006,706617,-2468,-1588,-4056
48,RIGA,LATVIJA,2007,702561,-2051,-3238,-5289
49,RIGA,LATVIJA,2008,697272,-1372,-8457,-9829
50,RIGA,LATVIJA,2009,687443,-1635,-12375,-14010
51,RIGA,LATVIJA,2010,673433,-2303,-11712,-14015
52,RIGA,LATVIJA,2011,659418,-2355,-7210,-9565
53,RIGA,LATVIJA,2012,649853,-2182,-4056,-6238
54,RIGA,LATVIJA,2013,643615,-1972,1725,-247
55,RIGA,LATVIJA,2014,643368,-1472,-889,-2361
56,RIGA,LATVIJA,2015,641007,-1243,-134,-1377
57,RIGA,LATVIJA,2016,639630,-1159,2952,1793
58,RIGA,LATVIJA,2017,641423,-1996,-1456,-3452
59,RIGA,LATVIJA,2018,637971,-2423,-2934,-5357
60,RIGA,LATVIJA,2019,632614,0,0,0
61,PIERIGA,LATVIJA,1990,378728,1059,-1538,-479
62,PIERIGA,LATVIJA,1991,900455,-1481,-9233,-10714
63,PIERIGA,LATVIJA,1992,371652,-959,-4419,-5378
64,PIERIGA,LATVIJA,1993,371652,-959,-4419,-5378
65,PIERIGA,LATVIJA,1994,366274,-1572,-2415,-3987
66,PIERIGA,LATVIJA,1995,362287,-1714,-865,-2579
67,PIERIGA,LATVIJA,1996,377696,226,-6270,-6044
68,PIERIGA,LATVIJA,1997,358652,-1368,393,-975
69,PIERIGA,LATVIJA,1998,357677,-1725,1557,-168
70,PIERIGA,LATVIJA,1999,357509,-1565,2155,590
71,PIERIGA,LATVIJA,2000,358099,-1028,2561,1533
72,PIERIGA,LATVIJA,2001,359632,-1495,1533,38
73,PIERIGA,LATVIJA,2002,359670,-1342,3099,1757
74,PIERIGA,LATVIJA,2003,361427,-1301,3184,1883
75,PIERIGA,LATVIJA,2004,363310,-1251,2427,1176
76,PIERIGA,LATVIJA,2005,364486,-942,2855,1913
77,PIERIGA,LATVIJA,2006,366399,-668,3166,2498
78,PIERIGA,LATVIJA,2007,368897,-507,4350,3843
79,PIERIGA,LATVIJA,2008,372740,-192,1987,1795
80,PIERIGA,LATVIJA,2009,374535,-206,-411,-617
81,PIERIGA,LATVIJA,2010,373918,-536,-1430,-1966
82,PIERIGA,LATVIJA,2011,371952,-553,-1271,-1824
83,PIERIGA,LATVIJA,2012,370128,-381,240,-141
84,PIERIGA,LATVIJA,2013,369987,-153,-2796,-2949
85,PIERIGA,LATVIJA,2014,367038,-23,594,571
86,PIERIGA,LATVIJA,2015,367609,90,-1352,-1262
87,PIERIGA,LATVIJA,2016,366347,253,-1646,-1393
88,PIERIGA,LATVIJA,2017,364954,44,2268,2312
89,PIERIGA,LATVIJA,2018,367266,-265,3588,3323
90,PIERIGA,LATVIJA,2019,370589,44,2268,2312
91,VIDZEME,LATVIJA,1990,272289,763,-1112,-349
92,VIDZEME,LATVIJA,1991,271940,251,-647,-396
93,VIDZEME,LATVIJA,1992,271544,197,-2803,-2606
94,VIDZEME,LATVIJA,1993,268938,-750,-1460,-2210
95,VIDZEME,LATVIJA,1994,266728,-1354,-807,-2161
96,VIDZEME,LATVIJA,1995,264567,-1538,-515,-2053
97,VIDZEME,LATVIJA,1996,262514,-1325,-380,-1705
98,VIDZEME,LATVIJA,1997,260809,-1276,-216,-1492
99,VIDZEME,LATVIJA,1998,259317,-1716,15,-1701
100,VIDZEME,LATVIJA,1999,257616,-1323,-206,-1529
101,VIDZEME,LATVIJA,2000,256087,-1084,-2251,-3335
102,VIDZEME,LATVIJA,2001,252752,-1200,-2182,-3382
103,VIDZEME,LATVIJA,2002,249370,-1231,-1462,-2693
104,VIDZEME,LATVIJA,2003,246677,-1307,-2028,-3335
105,VIDZEME,LATVIJA,2004,243342,-1341,-2351,-3692
106,VIDZEME,LATVIJA,2005,239650,-1245,-2651,-3896
107,VIDZEME,LATVIJA,2006,235754,-1491,-2433,-3924
108,VIDZEME,LATVIJA,2007,231830,-1425,-1981,-3406
109,VIDZEME,LATVIJA,2008,228424,-1079,-3198,-4277
110,VIDZEME,LATVIJA,2009,224147,-1259,-4680,-5939
111,VIDZEME,LATVIJA,2010,218208,-1366,-4847,-6213
112,VIDZEME,LATVIJA,2011,211995,-1225,-2042,-3267
113,VIDZEME,LATVIJA,2012,208728,-1190,-1589,-2779
114,VIDZEME,LATVIJA,2013,205949,-1159,-2875,-4034
115,VIDZEME,LATVIJA,2014,201915,-1012,-1876,-2888
116,VIDZEME,LATVIJA,2015,199027,-1016,-2013,-3029
117,VIDZEME,LATVIJA,2016,195998,-1016,-3188,-4204
118,VIDZEME,LATVIJA,2017,191794,-1088,-2212,-3300
119,VIDZEME,LATVIJA,2018,188494,-1141,-1258,-2399
120,VIDZEME,LATVIJA,2019,186095,-1141,-1258,-2399
121,KURZEME,LATVIJA,1990,365733,983,-1196,-213
122,KURZEME,LATVIJA,1991,365520,492,-2167,-1675
123,KURZEME,LATVIJA,1992,363845,7,-11216,-11209
124,KURZEME,LATVIJA,1993,352636,-867,-6004,-6871
125,KURZEME,LATVIJA,1994,345765,-1637,-5433,-7070
126,KURZEME,LATVIJA,1995,338695,-1608,-2551,-4159
127,KURZEME,LATVIJA,1996,334536,-1590,-1568,-3158
128,KURZEME,LATVIJA,1997,331378,-1627,-2813,-4440
129,KURZEME,LATVIJA,1998,326938,-1633,-983,-2616
130,KURZEME,LATVIJA,1999,324322,-1323,-778,-2101
131,KURZEME,LATVIJA,2000,322221,-1118,-3596,-4714
132,KURZEME,LATVIJA,2001,317507,-1400,-3131,-4531
133,KURZEME,LATVIJA,2002,312976,-1260,-2064,-3324
134,KURZEME,LATVIJA,2003,309652,-1204,-2522,-3726
135,KURZEME,LATVIJA,2004,305926,-1388,-2752,-4140
136,KURZEME,LATVIJA,2005,301786,-1281,-2582,-3863
137,KURZEME,LATVIJA,2006,297923,-1111,-2789,-3900
138,KURZEME,LATVIJA,2007,294023,-977,-2409,-3386
139,KURZEME,LATVIJA,2008,290637,-834,-3835,-4669
140,KURZEME,LATVIJA,2009,285968,-1117,-5564,-6681
141,KURZEME,LATVIJA,2010,279287,-1401,-6743,-8144
142,KURZEME,LATVIJA,2011,271143,-1409,-3301,-4710
143,KURZEME,LATVIJA,2012,266433,-1344,-2334,-3678
144,KURZEME,LATVIJA,2013,262755,-1272,-3449,-4721
145,KURZEME,LATVIJA,2014,258034,-1011,-2301,-3312
146,KURZEME,LATVIJA,2015,254722,-957,-2677,-3634
147,KURZEME,LATVIJA,2016,251088,-1259,-3512,-4771
148,KURZEME,LATVIJA,2017,246317,-1378,-1907,-3285
149,KURZEME,LATVIJA,2018,243032,-1547,-1372,-2919
150,KURZEME,LATVIJA,2019,240113,-1547,-1372,-2919
151,ZEMGALE,LATVIJA,1990,319762,960,-1051,-91
152,ZEMGALE,LATVIJA,1991,319853,556,-1305,-749
153,ZEMGALE,LATVIJA,1992,319104,232,-6327,-6095
154,ZEMGALE,LATVIJA,1993,313009,-962,-3456,-4418
155,ZEMGALE,LATVIJA,1994,308591,-1484,-2557,-4041
156,ZEMGALE,LATVIJA,1995,304550,-1617,-1473,-3090
157,ZEMGALE,LATVIJA,1996,301460,-1591,-1065,-2656
158,ZEMGALE,LATVIJA,1997,298804,-1453,-697,-2150
159,ZEMGALE,LATVIJA,1998,296654,-1597,-483,-2080
160,ZEMGALE,LATVIJA,1999,294574,-1034,-273,-1307
161,ZEMGALE,LATVIJA,2000,293267,-1147,-1209,-2356
162,ZEMGALE,LATVIJA,2001,290911,-1372,-2032,-3404
163,ZEMGALE,LATVIJA,2002,287507,-1320,-1123,-2443
164,ZEMGALE,LATVIJA,2003,285064,-1063,-1580,-2643
165,ZEMGALE,LATVIJA,2004,282421,-1214,-1698,-2912
166,ZEMGALE,LATVIJA,2005,279509,-1312,-1743,-3055
167,ZEMGALE,LATVIJA,2006,276454,-1064,-1599,-2663
168,ZEMGALE,LATVIJA,2007,273791,-1111,-1557,-2668
169,ZEMGALE,LATVIJA,2008,271123,-766,-2632,-3398
170,ZEMGALE,LATVIJA,2009,267725,-968,-5173,-6141
171,ZEMGALE,LATVIJA,2010,261584,-1312,-5161,-6473
172,ZEMGALE,LATVIJA,2011,255111,-1360,-2256,-3616
173,ZEMGALE,LATVIJA,2012,251495,-1106,-1544,-2650
174,ZEMGALE,LATVIJA,2013,248845,-945,-3025,-3970
175,ZEMGALE,LATVIJA,2014,244875,-781,-1944,-2725
176,ZEMGALE,LATVIJA,2015,242150,-948,-1846,-2794
177,ZEMGALE,LATVIJA,2016,239356,-894,-3045,-3939
178,ZEMGALE,LATVIJA,2017,235417,-859,-1799,-2658
179,ZEMGALE,LATVIJA,2018,232759,-1367,-1061,-2428
180,ZEMGALE,LATVIJA,2019,230331,-859,-1799,-2658
181,LATGALE,LATVIJA,1990,422311,-386,219,-167
182,LATGALE,LATVIJA,1991,422144,-852,-222,-1074
183,LATGALE,LATVIJA,1992,421070,-1412,-3875,-5287
184,LATGALE,LATVIJA,1993,415783,-2826,-2963,-5789
185,LATGALE,LATVIJA,1994,409994,-4128,-373,-4501
186,LATGALE,LATVIJA,1995,405493,-3951,-401,-4352
187,LATGALE,LATVIJA,1996,401141,-3338,-481,-3819
188,LATGALE,LATVIJA,1997,397322,-3526,-205,-3731
189,LATGALE,LATVIJA,1998,393591,-3608,-764,-4372
190,LATGALE,LATVIJA,1999,389219,-3136,-423,-3559
191,LATGALE,LATVIJA,2000,385660,-2899,-3185,-6084
192,LATGALE,LATVIJA,2001,379576,-3085,-3654,-6739
193,LATGALE,LATVIJA,2002,372837,-3397,-2088,-5485
194,LATGALE,LATVIJA,2003,367352,-3252,-4219,-7471
195,LATGALE,LATVIJA,2004,359881,-3297,-4553,-7850
196,LATGALE,LATVIJA,2005,352031,-3446,-3858,-7304
197,LATGALE,LATVIJA,2006,344727,-3425,-3564,-6989
198,LATGALE,LATVIJA,2007,337738,-3013,-3111,-6124
199,LATGALE,LATVIJA,2008,331614,-2366,-6232,-8598
200,LATGALE,LATVIJA,2009,323016,-2668,-6274,-8942
201,LATGALE,LATVIJA,2010,314074,-3341,-5747,-9088
202,LATGALE,LATVIJA,2011,304986,-2813,-3997,-6810
203,LATGALE,LATVIJA,2012,298176,-2925,-2577,-5502
204,LATGALE,LATVIJA,2013,292674,-2594,-3842,-6436
205,LATGALE,LATVIJA,2014,286238,-2421,-2236,-4657
206,LATGALE,LATVIJA,2015,281581,-2425,-2618,-5043
207,LATGALE,LATVIJA,2016,276538,-2537,-3790,-6327
208,LATGALE,LATVIJA,2017,270211,-2652,-2702,-5354
209,LATGALE,LATVIJA,2018,264857,-2763,-1868,-4631
210,LATGALE,LATVIJA,2019,260226,-2652,-2702,-5354
